6 0 0 0 0 0 0 0 0 0 0 0 0 0 0 0 0 0 0 0 6
6 0 6 6 6 6 6 6 6 6 0 6 6 6 6 6 6 6 6 0 6
6 0 6 0 0 6 0 0 0 6 0 6 0 0 0 6 0 0 6 0 6
6 0 6 6 6 6 6 4 6 6 6 6 6 6 6 6 6 0 6 0 6
6 0 6 0 0 6 0 6 0 0 0 0 0 6 0 4 0 0 6 0 6
6 0 6 6 5 6 0 6 6 6 0 6 6 6 0 6 6 6 0 6 6
6 0 0 0 3 6 0 0 0 6 0 6 0 0 0 6 0 0 0 0 6
6 0 4 6 0 6 0 5 6 6 6 6 6 6 0 6 0 6 6 6 6
0 0 0 0 0 6 0 6 0 0 6 0 2 6 0 6 0 0 0 0 0
6 0 6 6 6 6 6 6 0 6 6 6 0 6 6 6 6 6 6 6 6
0 0 0 0 0 6 0 6 0 0 0 0 0 6 0 6 0 0 0 0 0
6 0 6 6 0 6 0 6 6 6 6 6 3 6 0 6 0 6 6 6 6
6 0 0 0 0 6 0 6 0 0 0 0 0 6 0 6 0 0 0 0 6
6 0 6 6 6 6 6 6 6 6 0 6 6 6 6 6 6 6 6 0 6
6 0 6 0 0 5 0 0 0 6 0 6 0 0 0 6 0 0 6 0 6
6 0 6 6 0 6 6 6 6 6 6 6 4 6 6 6 1 6 6 0 6
6 0 0 6 0 6 0 6 0 0 0 0 0 6 0 6 5 6 0 0 6
6 0 6 6 6 6 0 6 6 6 0 6 6 6 0 6 6 6 0 6 6
6 0 5 6 5 6 6 6 6 6 6 6 6 6 6 6 6 6 6 0 6
6 0 0 0 0 0 0 0 0 0 0 0 0 0 0 0 0 0 0 0 6
